WWWWWWWWWWWWWWWWWWWWWW
W  C         !       W
W                    W
WWWWWWWWWWWWWWWWWWWWIW
WIIIIIIIIIIIJIIIIIIWIW
WIWWWWWWWWWWWWWWWWIWIW
WIWIIIIJIIIIIIIIGWIWIW
WJWIWWWWWWWWWWWWWWIWJW
WIWIJIIIIIIIIIIIJIIWIW
WIWWWWWWWWWWWWWWWWWWIW
WIIIIIJIIIIIIJIIIIIIIW
WWWWWWWWWWWWWWWWWWWWWW
