WWWWWWWWWWWWWWWWWWWWWWWWW
Wa  C  bWd     bWi     kW
W   !   W   !   W   !   W
We     uWg     hWa     lW
WWWWWWWWWWWWWWWWWWWWWWWWW
Wm     gW      eWi     oW
W   !   W   G   W  !    W
Wu     nWt      Wd     mW
WWWWWWWWWWWWWWWWWWWWWWWWW
Wl     pW      sWk     oW
W   !   W   !   W   !   W
Wh     nWt      Wp     sW
WWWWWWWWWWWWWWWWWWWWWWWWW
